11111111111
10P00CC00E1
11111111111